1111111111111
1P000P0000001
10000P0000001
100000E0C0001
1111111111111