111111111111111111
1C0100110C100010C1
100000E10110001001
100100110000101001
100100U00011100001
100001011000001001
1111010C1011111011
1C00011010U01C0001
110101000010000101
110101111011111101
10C100C0000000P001
111111111111111111
