111111
111111
101111
100111
1PCE11
111111