111111111111111111
10E10000001C101C11
100000111010101011
1P0001E00000U10001
10000111000C000011
100011111110111011
101111111100111C01
100000000000011011
111111111111111111