111111111111111111
10E10000001C100C11
100001111000000011
1P0011E00000010001
10001111000C000011
100011111111111011
101111111100111C01
100000000000011011
111111111111111111