1111111111111
1C0000000C0C1
100000E000001
1111111111111