1111111111110
1P0000000C001
1000000000001
100000E000001
1111111111111